25 100
C#######################^
^.......................^
^.......................^
^.......................^
^.......................^
^.......................^
^.......................^
^.......................^
^.......................^
^.......................^
^.......................^
^.......................^
^.......................^
^.......................^
^.......................^
^.......................^
^.......................^
^.......................^
^.......................^
^.......................^
^.......................^
^.......................^
^.......................^
^.......................^
^.......................^
^.......................^
^.......................^
^.......................^
^.......................^
^.......................^
^.......................^
^.......................^
^.......................^
^.......................^
^.......................^
^.......................^
^.......................^
^.......................^
^.......................^
^.......................^
^.......................^
^.......................^
^.......................^
^.......................^
^.......................^
^.......................^
^.......................^
^.......................^
^.......................^
^.......................^
^.......................^
^.......................^
^.......................^
^.......................^
^.......................^
^.......................^
^.......................^
^.......................^
^.......................^
^.......................^
^.......................^
^.......................^
^.......................^
^.......................^
^.......................^
^.......................^
^.......................^
^.......................^
^.......................^
^.......................^
^.......................^
^.......................^
^.......................^
^.......................^
^.......................^
^.......................^
^.......................^
^.......................^
^.......................^
^.......................^
^.......................^
^.........ggg...........^
^.......................^
^.......................^
^.......................^
^.......................^
^.........ttt...........^
^.......................^
^.......................^
^.......................^
^.......................^
^.......................^
^...d....d...d..d...d...^
^.......................^
^.......................^
^.......................^
^.......................^
^..........$............^
^..........@............^
#########################