25 106
C#######################^
^                       ^
^                       ^
^                       ^
^                       ^
^                       ^
^                       ^
^                       ^
^                       ^
^                       ^
^                       ^
^                       ^
^                       ^
^                       ^
^                       ^
^                       ^
^                       ^
^                       ^
^                       ^
^                       ^
^                       ^
^                       ^
^                       ^
^                       ^
^                       ^
^                       ^
^                       ^
^                       ^
^                       ^
^                       ^
^                       ^
^                       ^
^                       ^
^                       ^
^                       ^
^                       ^
^                       ^
^                       ^
^                       ^
^                       ^
^                       ^
^                       ^
^                       ^
^                       ^
^                       ^
^                       ^
^                       ^
^                       ^
^                       ^
^                       ^
^                       ^
^                       ^
^                       ^
^                       ^
^                       ^
^                       ^
^                       ^
^                       ^
^                       ^
^                       ^
^                       ^
^                       ^
^                       ^
^                       ^
^                       ^
^                       ^
^                       ^
^                       ^
^                       ^
^                       ^
^                       ^
^                       ^
^                       ^
^                       ^
^                       ^
^         ggg           ^
^                       ^
^                       ^
^                       ^
^                       ^
^                       ^
^                       ^
^         ttt           ^
^                       ^
^                       ^
^                       ^
^                       ^
^                       ^
^                       ^
^                       ^
^                       ^
^                       ^
^         ddd           ^
^                       ^
^                       ^
^                       ^
^                       ^
^                       ^
^                       ^
^      b         b      ^
^           @           ^
#########################
......xxx...x....x.......
......xxx...x....x.......
......xxx...x....x.......
......xxE...xE...xE......