26 106
C#######################^
^                       ^
^                       ^
^                       ^
^                       ^
^                       ^
^                       ^
^                       ^
^                       ^
^                       ^
^                       ^
^                       ^
^                       ^
^                       ^
^                       ^
^                       ^
^                       ^
^                       ^
^                       ^
^                       ^
^                       ^
^                       ^
^                       ^
^                       ^
^                       ^
^                       ^
^                       ^
^                       ^
^                       ^
^                       ^
^                       ^
^                       ^
^                       ^
^                       ^
^                       ^
^                       ^
^                       ^
^                       ^
^                       ^
^                       ^
^                       ^
^                       ^
^                       ^
^                       ^
^                       ^
^                       ^
^                       ^
^                       ^
^                       ^
^                       ^
^                       ^
^                       ^
^                       ^
^                       ^
^                       ^
^                       ^
^                       ^
^                       ^
^                       ^
^                       ^
^                       ^
^                       ^
^                       ^
^                       ^
^                       ^
^                       ^
^                       ^
^                       ^
^                       ^
^                       ^
^                       ^
^                       ^
^                       ^
^                       ^
^                       ^
^         ggg           ^
^                       ^
^                       ^
^                       ^
^                       ^
^                       ^
^                       ^
^         ttt           ^
^                       ^
^                       ^
^                       ^
^                       ^
^                       ^
^                       ^
^                       ^
^                       ^
^                       ^
^         ddd           ^
^                       ^
^                       ^
^    uu                 ^
^    uB                 ^
^                       ^
^                       ^
^      b         b      ^
^           @           ^
#########################
.xxx..xxx..xxx..xxx..xxx.
.xxx..xxx..xxx..xxx..xxx.
.xxx..xxx..xxx..xxx..xxx.
.xxE..xxE..xxE..xxE..xxE.