27 21
###########################
#.....#..............#LLLL#
#.....#.......####....#LLL#
#.....#.......#..#.....#LL#
^.....#.......#..#......#L#
^.....#.......#..#.......##
^.....#######.#.##........#
^.....#.......#.....#######
^###.##.#####.#.....#.....#
^s.$.H..^.....#.....#.....#
D.@.....^.....#.....#.....#
#########..######...D..s..#
#..........#........#.....#
#..........#...#....#.....#
#.....#....#...#....#######
#.#### #...#...#....#.....#
#.....#....#...#....#..#..#
#.....#....#...#....#.# #.#
#.....#....###.######.# #.#
#.....#................#..#
###########################